1111111111111
1001000000001
1E00011111001
1P00110000001
1111111111111
